5 10
|---------|
|****|**-*|
|****|*@**|
|******--*|
|---------|